484,276,277,276,277,276,277,276,277,683
516,308,309,308,309,308,309,308,309,683
484,75,75,75,75,75,75,75,75,683
516,75,75,75,75,75,75,75,75,683
484,75,75,75,75,75,75,75,75,683
516,75,75,75,75,75,75,75,75,683
484,75,75,75,75,75,75,75,75,683
516,75,75,75,75,75,75,75,75,683
484,278,279,278,279,278,279,278,279,683
516,310,311,310,311,310,311,310,311,683
